21213123222
1         2
2   12    3
2         1
1111122   3
2     2   2
1  1      1
2  1      1
2  2      1
12123332111